bb------------
bb------------
bbs-----------
bb------------
bb------------
bb------------
bb------------
bb------------
bb------------
bb------------
bb------------
bb------------
bb------------
bb------------
bb------------
bb------------
bb---C--------
bb------------
bb------------
bb------------
bb---b--------
bb---M--------
bb---b---C----
bbg--C--------
bb---b--------
bb------------
bb------------
bb------------
bbpP----------
bbei----------
bb------------
bb------------
bb------------
bb------------
bb------------
bb------------
bb------------
bb------------
bbppP---------
bbeei---------
bb------------
bbg-----------
bb------------
bb------------
bb------------
bb------------
bbpppP--------
bbeeei--------
bb------------
bb------------
bb------------
bb------------
bbg-----------
bb------------
bbg-----------
bb------------
bb------------
bbpppP--------
bbeeei--------
bb------------
bb------------
bb------------
bb------------
bb------------
bb------------
bb------------
bb------------
bb------------
bb------------
--------------
--------------
bb------------
bb------------
bb------------
bb------------
bb------------
bb------------
bb---b--------
bb---M--------
bb---b--------
bb-------b----
bb-------b----
bb-------bg---
bb-------b----
bb-------bg---
bb-------b----
---------b----
---------b----
--------------
bb------------
bb------------
bb-------b----
bb-------b----
bb-------b----
bb---b---C----
bb------------
bb------------
bb------------
bb------------
bb------------
bbg--b--------
bb---b--------
bbg-----------
bb------------
bb------------
bb---C--------
bbk-----------
bb------------
bb---C---M----
bb------------
bb------------
bb---C--------
bb------------
bbg-----------
bb------------
bbg-----------
bb------------
bb---b--------
bb------------
bb------------
bb-------b----
bb-------b----
bb-------b----
bbg-----------
bb------------
bbg-----------
bb------------
bb-------b----
bb---b---C----
bb---b---C----
bbg------b----
bb------------
bbg-----------
bb------------
bbb-----------
bbbb----------
bbbbb---------
bbbbbb--------
bb------------
bb------------
bbbbbb--------
bbbbb---------
bbbb----------
bbb-----------
bb------------
bb------------
bb------------
bb------------
bbb-----------
bbbb----------
bbbbb---------
bbbbbb--------
bbbbbb--------
--------------
--------------
bbbbbb--------
bbbbb---------
bbbb----------
bbb-----------
bb------------
bb------------
bb------------
bb------------
bbpP----------
bbei----------
bb------------
bb------------
bb------------
bb---b--------
bb---b--------
bb---C--------
bb---b--------
bb------------
bb------------
bbg-----------
bb------------
bbg-----------
bb------------
bb------------
bbpP----------
bbei----------
bbb-----------
bbbb----------
bbbbb---------
bbbbbb--------
bbbbbbb-------
bbbbbbbb------
bbbbbbbbb-----
bbbbbbbbbb----
bbbbbbbbbb----
bb------------
bb------------
bb------------
bb------------
bb------------
bb------------
bb------------
bb------------
bb------------
bbbffffffff---
bb------------
bb------------
bb------------
bb------------
bb------------
bbx-----------
bb------------
bb------------
bb------------
bb------------
bb------------
bb------------
bb------------